1022
ABCBDAB BDCABA
ABCCDAB BDCACA
ABCEDAB BDCAEA
abc abg
bdf aeg
acefg abcdefg
ABCDGH AEDFHR
AGGTAB GXTXAYB
zaid sbdhas
dffss dsaf
gfsa gfsd
wyrew uhrdd
vghds wqet
dfuy hgus
juf dfj
bno hutas
hvgd jvu
dqw iuoi
kou fte
klio oiou
lku hjgsd
kjtyu jhde
LVKKU	AKSIG
OSCVR	ZCFOS
FWKJW	OCRBM
QTJOU	VBQMH
FXYDD	FHVAK
GFNWC	AZWGV
TIGNU	KBVBL
XNAFV	YVYIX
DXFGH	HFEQJ
PVXEJ	DICBR
ORXFF	YAQKX
MDOVI	OGALK
LFRIU	KWNHK
WARCY	RNBET
LRTZE	VFNBL
IOLNW	ZKNKU
OVJFC	QALJV
NAESJ	ESJKS
KRUUC	QINQQ
SJFJL	ELPET
JIZLN	CQNYH
QMUBO	EFLFC
MMSIL	NQPHZ
BQOXL	FRVUA
HSDCQ	QDXHI
QDHSF	BLLAN
DIBIH	KRNFL
USCSC	HLBDY
JKAEG	SOXLG
PVUQJ	PZOBB
PXBZH	NFMOO
LAFTM	EPFWW
EGUUC	EMFLF
GOQXE	YYLPJ
KKJJC	NGEYQ
SKVCQ	ZOKWE
SBRGJ	GRPMX
OAPSX	FCJKN
FARIK	OAOLB
QDKWM	CPYKM
VOFSN	WAOPF
UAQPG	CMXGH
RTQHA	YKSFI
VFCKM	VAHMG
QFZNN	ESKZC
ZJZPT	QHTID
ACIVV	VCHVG
JMXXV	WAREL
QZWLA	HHXNA
CRWHY	SDHBN
MMTSI	TETHD
BXODK	JRMES
FJGAS	MAPPF
PMAXT	AVFJR
CHJND	LULKA
EWAFK	JZNSU
GUMBU	ERDTS
UFLDX	JHQWM
ZQZGM	TMJMR
ZIKIB	JYWMF
ENCQQ	PUELB
RLWZW	RTARI
ISORG	AJHQY
XVFIU	EFSTB
QCHYE	OBXXL
FZTWE	KLARD
BNTMH	VNXPL
LCBEK	QIVNA
LDTDZ	SEOBZ
FSDXL	XJXQW
UUPDC	OUOOD
NOAUH	BQRQP
VOWUM	FPIYK
CTAKV	CNPBX
KOIPS	ZRQAN
GGFME	HGRRK
GFQIK	DXZMI
RPLKP	PFXRY
HXUAW	GSQRC
RDFXK	SHKQF
MDAJG	PCHUK
JVPHP	RGIHE
SLAHC	TQOQZ
CKOTH	WCTMY
XDDNC	USKDA
XFEMQ	KZJIR
PJQRM	XUBXQ
CGZRB	CZMQX
YCPVV	VZTRE
ZLPAQ	GUTKI
CEZEF	ZJZBQ
UKGXU	OZBKP
EGNPX	QXOFG
ONWXD	GVSNX
OVSPW	APPDU
LTMFF	EYJLG
IGGWZ	YHELV
NQQTM	ISCBC
MXUXI	LOWCO
HNITH	RSUIG
KELJV	YIUDU
YRIHM	MPNHR
WIRBZ	HEAPY
XWBEX	QGARO
ODJRJ	VACXE
WXMNI	KQOIX
SYDUY	YCCBE
IXQVL	YGRVQ
HZKQT	SQRRX
PGOZU	TCNTA
ONFAQ	KLYCM
FDWGY	MFVDU
HAAZN	ECORZ
PNEMD	KFICR
BIUNF	HKSKJ
BLRGF	RKJEW
IBICZ	PYVEK
XPZFS	OCLJG
ABNYC	OOMHM
YSSZS	DZVJM
PLANL	SGKAK
AOHCT	RFDEV
WAKDW	KYASP
FSWWH	XRQCR
QGLXR	XPLRE
PSXLP	ZCDIK
XFYYO	SZFXW
UZHED	DAIKN
HGGLD	XKOWI
QCQRQ	MCFIC
PKZHH	DREGX
TZKIT	ZSENU
MKOEH	VWLKS
KGJRH	BCEWU
XEITZ	AMDFT
NQISG	SDKGW
NWARC	MOQIR
LMRKD	OJMZU
LNPOO	WOTTE
SUMUJ	LRMGS
DURKA	ZARVM
HLYMF	ERZVU
JYATV	QUDKX
GGACD	EFBCI
UJKNJ	RVQMM
XRFBL	JEPDX
YNKXE	EISPS
AZHCB	CPLOF
ESKAG	RWONZ
HXQDP	KMJKA
EYUKQ	FXZXD
PFRDG	VLODK
LKOLJ	GGHQN
ILNCS	NCWII
HSEXR	OTFXD
CUJST	CYPHW
SZHFF	PSJIK
LETEH	CJOYG
NFDQK	HHYVF
YOAPV	JEVSC
FVQUT	ZQQGX
UYTAS	JIDJM
HUHKK	KJQDD
ODUXL	HZVKG
CIJIG	GVDYZ
JBIEK	GFQCX
XDDSD	UJZSW
TCCPP	QXWYE
OKFWI	OSCNV
JILCF	BEPZT
OSROJ	JSLVA
TZMZN	ITNOW
ZTRLL	HUNSO
JAGUY	WNUFT
BZTQD	LDSJK
HEUPD	FGPJD
WTGJG	SOPRP
NBQUT	XDPXF
SOWCE	NGXEO
SDICK	NQIEE
BPANX	MEAFQ
UFSIS	CUZQT
SBDKU	WIFGH
VLAMV	YSMYC
ZOCXW	JTDMW
HRDPC	GCABZ
XKKXK	FQJBN
QDOME	JWBEC
GRGNS	QUTXF
RCMUP	PFSYH
BYUWM	SGBWP
SJOSV	CGSKQ
GDZLK	DHQMN
HGXDS	WPMCJ
YFDYA	HOZNP
XISJA	XXJHS
ACWXO	LJRKZ
JAETG	DIXLH
UJCFR	LGKNK
SEIYJ	TEWJS
BDHPO	RHMVX
AYUGP	CHNLP
UQTCQ	RHGML
ESCRY	PPJFR
QJURT	ONPNB
TJZPB	CHEAL
GQHJP	EKTFM
JHXXI	RSWWJ
ULNFL	CLXZY
PNWZD	DRXXM
CAQWO	HAILD
DIUZU	EIFJY
YUAIJ	DISXJ
ZFHEM	KJCEA
VOAJN	QHWYH
TSAKB	AVWJX
VJFCA	ZRFLD
LOMOV	FZGXK
HJXBH	RBJJS
QYFNC	JTSEU
XLXDX	KNQHL
YXOHB	NNATU
GDCVZ	BLTJZ
IMUHB	IQTWQ
WKRYS	OZQFZ
CWHXG	GMQDB
ZLKNZ	FVPDG
KRIKH	OZRDN
QBXQH	BLFTF
CAVVS	DFPNI
UOOCH	NTXQN
UXLFT	WEXIJ
TPVCC	PRRJG
HEXIS	AOVGA
RVJKJ	BGTFN
BLZVE	WMWUI
XNPZW	ZQBVR
QAGCP	AMUBN
CIGFN	VBNYK
HXJZN	NKOMG
SMPYT	UYAEQ
BDZFT	HPOYB
NSUFE	PKFYE
ZFQJB	CESLX
FFTUO	BSCQJ
QVJKV	VSITI
WPGWV	VQWFW
MSCYQ	NSNJH
WLXRL	FGGJS
IZDUS	QECIB
SQEPK	QJRSP
CRNRP	EGWQK
RCZPA	ZTJDA
PGAYJ	CZDNU
IEDJQ	UAFYY
AQZTP	HHEIL
JTWBA	UEFLM
QNVEL	RYFPA
TZMAN	OSTRP
MAZDQ	JSNMJ
VKDPK	JZOTL
ZQYCD	DPGJS
VZYII	MFUXO
XTIKF	ZBDJI
RQGSK	IGJHZ
ESHPE	KIXSZ
QYJNY	JPZMX
HQKYR	GCOUK
EEYAE	CUGIS
ZWRHV	JUSAX
AQIWB	KSSEM
BNUBT	BFVSC
IXHTN	XICJJ
JYFJP	OCXUU
BZJUZ	KLFSX
EWLJT	FMLDE
ZBVXG	BOGCW
MTDCP	BUWIZ
ZWCMH	OIQKD
NNDXB	APXJV
ESLDL	PBANJ
CAMIN	QQOEE
CKKDR	EDHFN
HBSNI	AFTQV
TVAMX	EWLDT
LMRJU	FOKWA
ZFSMM	GHQIW
IIUKV	OXPSP
UZJNV	YTIWW
QSVBD	AFZJA
AGKRT	NIZDV
PFJHW	EJTUK
WNPWS	ZRDJW
INEWS	QJNFH
DUWBJ	HACEN
ESJWD	WQTPE
BCERP	WNCKR
KPEGC	QUKYD
SNREX	SMTOH
DQIEG	GGMQP
ICMHD	KUGXU
YHSFH	LRDNO
TIXDP	UNEIQ
PPYWS	CWWMS
FRGWT	HMPLF
CVNUV	EPSPL
CNYYM	USPKH
WUYAG	JOVLU
CGZMJ	DYWJO
ZCIIH	FYTKG
STNMD	GMXZC
OWJQU	BMDBT
EHKBK	KXZFS
JUNGB	BUUAO
WZZNH	VNOSJ
NAHHF	RKKYT
TJVOF	VODMK
DXCCL	KMFVX
ROZDH	DEPWI
UCYNI	MIIJX
TXNBJ	ZUNOS
UAVVW	CUNPN
HLGTD	XCOTZ
HPFTO	ASEIW
VZYIC	HXCRX
WYUKN	UCWJN
PAHMI	BRNIU
KEBCL	MPCKM
UMTCR	JBMDM
RAZNS	XUDRZ
DHROU	ZUNFR
RJZJE	FRYMK
YQSEX	SHYRD
SCEPE	DAKBH
LGYUK	OWSUQ
ZEQZZ	MPQWM
SDJKA	CNKXV
OPOCD	FNABC
EMNOG	TXIMF
LQLPC	ZBIAY
XDMGO	JCPZI
CZHUZ	TEPYJ
EDDPV	HOHIZ
EOYWM	EAPZC
RGPZQ	DRDBV
DASKN	DDLXP
UCELA	CJCIY
ECDCR	EMBMG
UOJNS	DYWYS
AHKBC	EYWQF
KWAYZ	LZDFX
UWGIN	WDXKX
ITGBT	AZMRF
WDCEQ	SJBLV
BUSJA	WFPFY
KHQAK	PIPPM
FQESH	XSZAU
GJFTP	TVFWZ
VTZSY	UTBOI
THCDB	AWPSC
JLMWF	QRRLY
PVTAB	YJUON
UQJBW	SGODV
AZOKL	XIFIS
CUBJY	LPVCS
BSCLU	FARYR
JVDDW	DPZCF
ODYVE	WGGLZ
XUHZY	GCLZA
MSOXD	OPADY
PWWZA	YRYIH
ERGNK	OGQNK
WKZMG	WJHFZ
ZVIGH	OXPCT
QPXCK	QBAHZ
YGVGU	MGZKS
QNQIG	XTBKP
EQKDV	ZDSSX
EHLQA	JFXOF
MFFQT	RXKZL
LEAAJ	SQQNL
RMQRA	YXOTU
TCMCD	YPTMA
CJEVD	WZKYT
MFJZR	QDQDA
FQENY	WYGJW
NYTRZ	NZDNI
AKMLL	JLCGI
PTKBM	TTYNU
DFKWI	ZPIGZ
NQIUX	STIFU
IYUHQ	WRPTK
ZNPRX	WEFWR
ITYOG	PRKBT
GCGKZ	PYHIU
VBCJL	JTMSW
OMXVZ	XFEBI
KGUXP	TDJEK
LSECQ	HCXMQ
EZIXZ	SWKHP
TEZVQ	SIPWM
LGVXZ	VVXUZ
UAALS	FXOKL
QHCYB	GMQPS
YTLKG	SJQUA
CFUQW	UIJKS
GIVSK	DJVRN
WWCJL	APIBR
USBYD	QWCYC
EDNNQ	JAADG
PFWJP	OWJKZ
BLXID	PXPJX
QHJYN	GOIYB
CCDTM	DHWNN
VSZGB	KLEJI
OFWMS	CYGBK
FDLEV	QHKCL
KULCH	MNISK
PUEOD	ULILF
JVROE	PJTJA
WUNCZ	GYBSQ
RYYDY	EPCHF
EYRUK	HKUUG
SXQXG	CKJTW
ITOFT	VUVHI
JRHGH	WCKGR
IHWXC	MBKGT
EJXLF	YSTNW
HPBZQ	OSBFO
DDMZN	OMYBQ
TCFXX	KKXRW
XZFQD	JASGE
RVIAH	NEGTQ
EOAYW	UVBTD
BOVMA	QPONF
UAWOX	JTRWY
WDKBO	ISYQS
XCYUF	NQOEO
NPWFW	UUSNN
DPVVR	EHMRB
DIAWK	WTJJG
QJEGM	IMFHJ
CJJMA	DXXEI
QPKCF	TTLAM
LWKJN	QMMQL
NFLXX	XRATD
WWCTO	XGJYO
PAEXW	RONKV
MDXRW	OMOKW
QDPSW	XOQQE
EXDBD	GUMXE
OPBAL	YZXDL
FBITK	UPGCF
TQIDF	RRDDE
FSRXF	VUZDJ
RGKIR	TUXIU
RTWPN	YBMNA
DMYEO	QPNTA
NFGJW	KWIJO
AXWWK	ZPPGT
LFTCA	JEHUK
QAMSH	YBONH
IKWZB	AGTYP
AYRRM	BBCEI
CZEUU	OVTRH
TCJXI	NPFCF
AZAXG	QHILF
LDBPY	STYRH
NFTGZ	FHIBN
QOAUB	XVBCW
DGFBR	PKCQU
TPWEZ	LMOSY
QYYZT	GLERT
LLXHI	VPYWZ
PPAAG	AMAPR
EJXSI	SLSLK
IGNTX	SIYCF
NVSFW	DZGSJ
SKKSR	SAHBH
MGHZP	ZYMRJ
GWHSQ	HAOLB
ALCFL	SGOPC
GIMYG	ZPWEA
QGJXL	WFOPL
XUVGV	IHTPC
RPQXU	PZGMO
JBQAX	SGTVK
NJKYL	DKQKJ
QPUWB	CYBWH
EHSGC	NHIKB
MNXPE	QTQJK
CIJTF	SXBLD
FILJF	RGYVC
CPNFF	BMJDW
CQGCB	BGAST
MINMM	LFOGX
ZLYNL	WEGZH
ZHCGV	DXOIH
OABIJ	FIDZP
KJFNJ	XQWSK
NQEFL	IATTU
MVLDD	XJYUI
ESYCI	TKVWU
XRMMI	YTWDF
WIYQQ	FFWVA
CJYIP	ATWKI
SSVKU	DQNRN
EFGNL	COWOQ
QNMUF	KNIJY
DDSTX	SJRDT
OUYBJ	XGWYL
QIZVW	UADPR
BVQZR	TYXQD
ENGAQ	CNFNZ
BBKFJ	VUQIG
JZMXN	KGTUO
LAWFX	TVZKA
RRVHV	WXRUC
XTPCE	TYZAH
AFHEK	OJCWJ
KQDJI	YRRYB
TOSCX	XNUAC
RHZOG	EKURN
KBQFQ	XHSOE
JKMQA	CUGOT
OSXZG	QCQVD
RCXYJ	TRQSZ
RZYDJ	TAAFH
ZAEIY	MZWTW
UYJXF	QVXMJ
TSGRM	WHVGO
SBYVE	ZVKZB
RETMA	VXJJG
WVFVC	PFOWR
EGROC	DWTZJ
XNUPP	LJQJE
PEXAG	YKRNC
YFWQZ	CSSBJ
FKQRI	DOHID
EZOTR	HPKIC
UOQJT	MCZLK
MCYSM	VCOII
BMIJH	QFZSW
BENAH	FIBUG
LMCCQ	YDRSV
ZEMHE	PCLLL
GANII	UMCNN
KPLJW	ILHNL
TEAJV	UQKHI
NTAKV	WCXFK
ESAJG	RONJG
EXCJL	CKTZC
AHHYK	APSHR
LSIKM	PWZOX
MWCUV	XKCWV
IQZMF	XQUKF
ZCNBK	MTTOO
ADQDR	OICXT
SJLLP	LOCYS
MCYPT	FWOXI
ITCXL	SNWWZ
RTNTH	WWIIO
GOUGE	WBRMB
PNZAV	UNQDA
MIPQY	WXGJZ
YYNHU	DJAXZ
OUOEA	BMMIH
KVQHX	JVYAD
BMMJL	DRBUG
EPWZG	JRDQZ
JVNBS	CPNZV
TQTIA	QUFPO
MEIKQ	TAJNR
JEBWD	YRENC
BRYRA	AFJFK
WFHHG	OBKTT
GIDKT	TYRKA
DJYXA	XFHMO
FLXLK	BWLLV
GESRE	TDFND
OCNWA	RZOIC
QLCXQ	FYVZL
EBWOX	QMUIS
GIHKG	VSAUE
HYIBK	NODDH
TEGVI	NEGBD
TAJZO	MKSLU
QKNNJ	AZHST
UESBR	RCIYE
LRAZJ	TTIMT
RSSXZ	PDFQG
EPNGT	DODCL
TIBSK	EAKEL
EKDCP	RVBIV
CAKSB	UWNJL
NRNYH	JBILG
UDVUE	RVNPE
XOXDZ	BHFAA
UGEGN	DGALU
YHRFJ	QAVEZ
VQSZG	GQTWT
GQSEG	VAREF
ENJIA	SNPVR
XBYMR	QPRKV
BAHPZ	FUEBB
WKBUH	DQBAJ
DFZAX	UHZYV
THUOJ	EWPGK
ZNLDN	QULSN
BXJZV	HOLTE
JDQSN	QUQXC
LNSWJ	XXZGW
JZERK	XWMAA
IFTSP	LRNGV
QNZHD	AMNIA
GCBJP	EOJFT
QGFIN	KNDRV
IIBIF	NDPRG
STAUF	HYNWL
ZDLGF	ZILTG
KZRRK	VSRYS
XIOUR	WPPAO
LGLLS	WKLLN
DVIGO	LYGKP
VMGKH	ETBWN
MRSUY	XQMAO
FXILF	BZQOP
UZFSK	IOIPQ
RKMJZ	LGVAG
QZNLR	OHKKS
IGWTW	TYNLD
GIPDF	UEXHY
YPLXL	JHHNZ
DDRGZ	KJQPY
XTJOR	TNCFY
MZFHK	OMHIV
FYACX	SVWLA
JOUPJ	UJIEF
LRXVK	RKKFP
YBFQO	YRQON
VEEFE	YPVBS
VRGTX	RGMWE
CUQTD	DNAQX
VTIHL	RMQBA
BKLJL	UVBVX
BGVFQ	ZSGUQ
HOEIP	LPTUS
FQWWB	SHCEE
SHDBL	AXQNX
HCATN	YCJQR
RENBX	MRBNS
GANDR	TPWMS
LTREW	TGVCN
JDGXG	LXWIZ
FBAVL	QJUWG
MFDFS	KGMRS
YFZVW	VFFWW
LUVUF	WJLSX
NYSNF	SSJTV
WKOFT	ESCLL
HUBPR	OOLDU
XMCZV	GLWKU
DNCEE	IJZBI
RYAVB	XNHGJ
PCQIJ	THLHT
KBXEB	YAXQL
TKUAJ	XYXFL
FBGHU	KRVFQ
EXXSR	XNREE
XTFYM	JOAVN
MORKC	TIIKW
VUFXV	SKVJM
JBIFL	UJTUK
WOHIA	OXIPS
NGYKG	XJAJW
WAATD	UZUWT
TCSAZ	NOLHY
RMXSA	HCCFL
AXAGR	MNMMH
BXBDY	ZRVFQ
WORSS	OVHRZ
BBISR	YQAEE
KIQWX	LKAQD
GWNZM	DVUZF
JHXIG	YXNOX
VPPAP	TFKZK
BKCMS	FQNYQ
GSVPR	KFJTH
XNQMS	LCHLS
CXOHM	ZTNVY
HXITV	TYDDR
QZWHU	JBNHI
YJTDT	EYCPP
ZKAZJ	HKAPX
OEWNO	GMTMY
UXVHR	ANBIC
QCQWB	DITIO
XOAKN	IBAGS
BKWYG	UTSTZ
TORWV	VHJYY
FQCSV	RERST
KARKN	RRMLN
AHSYM	XEDRZ
CUZIP	CHNJI
FKTIT	WGPGJ
UZICF	CYCFB
AVTXD	IQINJ
DIMDZ	EUASX
XTQAS	UUDVA
NMBUA	NSUII
PYYTF	BPWTQ
TCNMH	FIKWA
DGWCG	YRDOK
LELKR	DRPIC
ZGBCL	CYWRW
UEXWJ	ASRGZ
DNIAE	IQMTM
JCHPN	FZRAG
JZAKC	UXLTW
ZDERJ	XCSMK
XUHYK	MTEJU
CHFCD	QHYDN
ZNHGE	RSBIX
YYGSM	GDPPJ
WBVZI	GMCCM
SHFFF	ILXVF
NAKWP	FIHJC
SNWSE	AYILD
SHUHY	RYWUO
CZRBA	TKWDA
ODBWT	WSICD
ZWMQM	AJHGB
JLZJB	BTJNI
DWTUF	BNJOT
NNIEI	MFUNR
IRXOJ	GYZLX
HJRPT	NNHTL
CYRPZ	XILEW
FUETS	CCVVI
ERJXT	AIGHY
QTDXO	BWPYA
DDNVJ	HALPS
XRXAS	LKVRN
WCASK	KQVPN
RBLKM	IHHHA
KSYMG	DEEKT
OTHQL	YVXOD
IAUNC	FSSPM
WQQRX	PBIWX
PJYNV	QPULO
EZGIS	QIGOA
MFRJT	CNXPM
NTAXP	OIJXS
OPTKE	UYEEX
RBJVI	YZEBV
KWSOH	LNCRR
BCQXW	GPYNA
EUHIS	MFYJO
BVUQJ	TJIVH
MLBOU	ONLOV
YKNFO	MDABK
KOQPP	DOBLU
LJEZD	EGJUI
VMZKJ	KTVJX
CAYUR	JLPJF
UHZTY	PVJMQ
YVIWO	UHLGS
MNOLU	TUXDM
YXCZJ	KKHNL
DMDAX	RKMZH
YHQVJ	DOMAR
TTLSP	WIJKV
XEFGK	GOTVE
YXXPL	ZRLBJ
NWZZN	CHTHQ
VGNMI	ZCYWG
VFIWB	HNDST
KQXDG	PVJKO
MTEYI	QCHXN
VKNWN	AECGP
OMUVK	CQJLZ
QXUBU	IQSGX
PZUTR	DUUWB
QDAKO	KPMVX
SHLBG	AVPII
ZUKEW	WIAWW
QZNUK	MBVEK
EBFIQ	WGJZR
LDFRE	OALQZ
FDQOB	LOAJY
SDVLE	MSGCB
EDCQU	JINBC
DQPMY	QTYDQ
NEJEY	KFJBE
WKJSE	PRKPB
VLQKY	RZSEB
VGQVT	PRCJP
XNHWS	LLYSF
HQPTK	PDAMN
QMMHS	MPOKR
EHZJL	LRKOR
WRULU	TSEDA
AQDRU	TANDT
MLSMO	AGGUI
OYZBV	RDUUD
PRVUF	PREDJ
YXPHS	WJLMR
HNHYG	ACNNT
VDUDR	OBUIY
RALVP	PJYMK
PASPT	BYLYT
DNCND	YZWYH
UIQBT	TPKUT
NLOKM	UAIGI
KSZJC	MNWKS
KWSUI	NRIFV
LZFSE	XGKLB
GYGGU	HWCEC
EZDAQ	XABIR
SGMXG	IXKAE
MZBSD	BFZWC
IAZSI	NQMMQ
KNAKE	HIJDY
LQDFI	DZSGF
KPZTA	LZFXX
VEDIZ	HIAVN
DERSF	GHCWB
HGIDC	FOVDE
SGFKX	IXBJO
JBQPC	GNAKG
YIYCY	HGBHZ
LOVMR	DTPAM
YDDQI	KMADY
FSOBP	CFUHK
BZHPH	GTLQR
WKBVQ	SESUJ
PMNYS	ROILK
HFCSB	ZBYBQ
OLHNR	BZGGB
QMWFM	LEDXT
MHHHT	QWURN
PEXGN	YDHKL
SFZBE	VYUKE
GRSCX	HYXOA
GXBIK	FQOUH
PZZXO	PCQIP
JFIPD	GICLB
AGFND	LANRZ
YQLET	LFKTS
NFECJ	MEXTM
CICJI	TZLLB
MMRXN	OANXL
BAAJL	AAFUM
AJBQP	JSKVE
DDTHT	VPNQS
IONZW	YNIZO
UXTTZ	UVMMM
CTHBQ	YKSVH
KCJXI	EDHJF
YSNNU	CRTQO
FEPKO	OMVPM
HCSUJ	SZZZJ
NQWFG	YHTGB
SGUVB	GNYLG
YNNOI	CNJUR
QIYJE	JOBDV
NKJJJ	FBYPD
EJBVP	IKRNX
MLKKN	QKGYA
AQCJI	JMGJJ
RCUEX	YKYKD
UIVSS	OTPQI
UPDJA	IDGFO
EGLBZ	KFVIQ
VTGIH	BBMKA
ZZZXQ	JKGWT
JSRLV	YIOYM
LQDTD	WXETS
ZLQCN	ONFMM
KBFCS	VGTUM
HBIWD	LRMXP
UWBBT	RMXKZ
VVFTG	SBBBL
TSKBK	MSNQI
GRSJQ	UFWAM
SGLVJ	JUSSH
PMJMJ	WBERH
PHFEJ	OVUBV
SESHY	PUMWX
TSNIH	LONGH
BMGGV	FGWYM
PQLPW	FBDBF
OIAKP	ARVTP
PKKYP	HJGJJ
ZTCVO	UYQNB
YNJAM	TDFZX
QVPEY	LRUGY
ZCPXI	XOQSP
WBWWI	LHCOF
UWRGY	GLTDO
GEAXE	MMAZO
VDBQG	AGXOF
BHYQX	DYWAX
ZPZRN	OUIIJ
KLPYU	QSOBG
TJHHX	HSUDW
UKFPR	CKMKT
ZCOEJ	FMDGK
CMTFU	FAALP
XAVTR	OZVWK
PYECB	SUIKZ
VLIDI	PPHLX
UPHDN	IIFLE
JJHEZ	MJSAZ
LTYTO	BGANY
QJTBV	QPCTI
YHZRB	UFKZH
UPZVC	CBKWW
YPXOP	ACVJT
FFGGR	TAAMA
YZXCG	DVLMG
QNLWL	KDNYM
RZEMC	CWACI
CZHKE	WCBOP
RMEAO	DQELS
VGKDB	IIXJA
PBWCX	JFVWR
CRPGR	PAJJH
BTAGL	TNROG
TZODP	JGYAB
PBRKA	YRGRG
RFXEG	MWWBD
JSZKI	LQDQE
CSODZ	TVNUH
KXLKB	QLZAF
ARVDG	VLAKC
WQBGM	ECQWS
PXKYK	DTVHE
GHVEQ	DRKZM
YMGHE	ZQMBV
ORYJL	BYZIV
AZVFT	QXZGY
VBJAZ	ZZSXI
EWMXZ	BMCNA
YUTSS	JWEPI
DBJHB	EPUCO
ILTIF	AGIXE
DECMB	EPYTO
YEDGS	YXHES
BDQCV	YEKIC
CPNYP	ZWJWS
ZMMNY	NUMDZ
UWCNE	YOKFE
YFUXM	IESCF
HJSXX	ZHPSR
IBXZA	IHUSY
GTZCC	BUGJZ
WDMWT	VEIKT
NJPIZ	EBVBN
EUUOT	OXGQA
ASSTW	WRMQA
BDYNX	HNTFI
IFGAC	MIKQD
CPPZU	BXGVO
TMVZQ	WITDR
GEAGI	BAVWQ
NBOTO	HMPVM
XKFCX	AFIIJ
SXQHA	TNDEQ
ZKLUX	SGAUP
JCBSX	EOBPM
OXMXD	RYEWP
CPLLG	FACGO
BYYOU	UKFQJ
YNPME	PVDMZ
SFBRO	EDPFM
COVHM	ZGVAY
BGMHP	NTJNA
KBUZC	IEIWP
RGCTR	BWIDN
FJLTT	WIJHG
AAZQH	YGMGC
JFQUX	QTOSX
NADVA	EMPMQ
XKQUK	XUAYK
VQSFX	LIJDM
OUMPI	ZEBYK
XFBZF	LHWCI
CYDXH	JKLHK
RWBDE	ONLCV
NFPQM	METTN
MZYNQ	KIMCT
NYSXF	NOWBB
BGVQI	CIHJN
UHBVQ	EFVPI
QTVXW	QYEBN
FPGMQ	EAFFD
CKLPL	ZTIWO
EZORG	ACVQK
GBRKD	CGQLD
