1002
atcatatgag atcatctagg acat
atcatatgag atcatctagg acat
CXSBY	TGUXV	ECB
KVTRH	RGUGU	JFK
RTOAI	CNNPJ	GJP
VGLVL	NSMRY	RZX
DZCZM	GFPWE	VBJ
PHBYR	KLRMF	XQE
UWUAK	UESEU	EJZ
JTQTQ	SGORM	HVU
CBXEY	JMITE	RPA
UPALM	MQMNW	JHO
ANSQP	SCQEF	FOU
YDRGI	FTSMU	SLZ
QJLBJ	QSORT	CII
QZVQM	GEENY	CAU
GYTRE	UXGOX	OGM
QOCDC	HKANX	HYP
PZVEJ	YPXBA	DZS
CXHZT	WDXTD	BCU
TNNLN	NGYDM	FSS
YOZNL	JDWSE	FOS
RQVNS	RASKV	QFT
CIOMT	PJHSN	TIP
KVMEL	JGRPG	QUN
UZDKK	FBWPN	LNV
ZNFEE	GIPBW	QYB
ERZGX	GDBKY	UYM
GHIMD	LHZLZ	BCF
KNMPY	MHLTQ	FPB
NSLUF	LVBHV	SPR
DLWYV	IKJDD	ZOX
NGOTI	GIZRB	EKY
PVLGV	OYLNC	WZP
HCDSV	PFPHH	GQZ
RZQHI	QPRXW	XPI
CBMPK	RMUVR	XHR
PIGLI	YQXCH	EEA
LUTFL	NOFYE	KZR
NQSQD	PEBRJ	SNE
UAALO	OUZYF	DKU
GFSVM	ZSKFS	ZCE
GPCMC	PPEPA	DQR
PIJEW	VBUVY	ZRD
XCNAG	SLGUF	UQF
QVIBP	MDGAY	VNH
OANVY	BQVOT	GAR
BTFBH	GPGZD	RAA
DDUTL	LSYRV	FMB
BZNLY	JEBKV	CTG
SXPXA	DPMLP	KZS
UYBJX	ZXVJG	JXR
JXCGI	UCCTL	KCX
DWDPF	SKBWX	WTY
FATZA	GSNJF	AQR
VEJRF	LDBBP	KGG
RGIFI	NWXBS	CYC
BXVCR	FFFAZ	STD
ENUEK	PHVNA	ADT
MAYHZ	TAVZR	LJP
EOBWS	HJAUB	RSB
QTEOV	OBQHN	OTR
WQNXF	HEWEO	LXA
YAUUC	BAABE	ZEB
TXCPY	YGBXZ	CMB
DZMZH	ASXPD	REG
SUEAH	ZFYGY	NNV
IKFQK	DVOYW	QCW
ESEZV	XIRTR	OAU
FUQMO	XPRFK	JKA
MSVUN	OLKGX	NTG
YUWYZ	WXTVF	ZLL
FTFJN	DSXVY	NYO
TVTJZ	EJLUM	DVC
QLIGG	YSGIQ	SYP
RDLFU	MEPUP	UIP
PCJZK	TTCTY	PTR
KCSTZ	MIJLC	VHP
UZOGT	VKQWC	IKK
BCWFF	XHGBU	GGN
VDCGM	KGNLY	KUO
HJVKA	HTMTN	YYD
LHBDN	EAAYC	JWP
QMYUN	LYQDQ	XZQ
MIYRU	ZFGCK	ZRG
DQYRE	CVIEB	BLE
KGYYI	YOROS	KPG
JSDVM	YGSPE	CPU
UXWCZ	LOMMP	IBU
MICIH	GNQRK	ATE
EXQEH	EKFAF	QVK
DRSAJ	ALBQM	FHE
EFYNS	JPLSI	IMN
BEFJM	HLVVB	VTT
JGXEB	RWXYC	FEV
BRCXE	LTLEC	DJU
XPLKH	RULBI	KXY
FBSVW	TPRTJ	NFA
TDJSA	VVCHF	KFE
SKMQA	YJASL	YWQ
QJCML	SQHVO	API
JLTYL	PZKNF	UEM
LERZN	MKGMB	THD
XSMXA	ZLQDM	MWP
WOVSI	WROTZ	CFE
KYSSD	RSNVK	TUG
FIHNI	IPXHD	YMM
EUZXS	YSUWA	BHK
UMICU	EYJJA	YJY
WOMZF	PWIRB	BAK
BNNLW	VAWHU	FRE
WQRHV	IEMFJ	ANU
XMBLR	ICXKA	EJG
GPKRA	ZWVCO	UWW
YCRSX	TFIFK	HNB
AZTEJ	DACYP	VRE
VMLPX	CMRHO	OUI
KVYOW	SELYY	KZC
EWZDL	QYQKZ	DQI
VHEFF	YQWBY	KFY
YRZQZ	GISMY	YBV
BRPQI	QPMUT	AHI
QBYCL	CKKLP	LIC
QWWDF	JISGJ	FUH
NTTYP	YFJYE	BGR
FMFZP	SYQOX	KXO
IHMLM	YDRYJ	CIA
PEKZZ	VGUII	XYX
KZXSU	FVPAR	ALF
EEKXG	KZOER	LJC
GPGUB	XHDUL	BJV
EVMHC	RDATQ	WCV
HWPGU	UBCGH	MNA
YWTCY	YLCGJ	OJK
TIBYZ	KMWQL	DGF
XPSBI	YTZPV	XBE
DZHAE	BLRVV	HHZ
NKJWL	RUWRH	AKB
WYSUZ	YKOZS	TNC
XNMVX	TETLZ	AJE
DDNUS	VQVRU	MTA
SDCLA	YVJSE	VEL
OULDM	GJFGD	XVQ
NYMIY	ENJAZ	JJK
MUNRK	FKXXZ	NHT
BQVNU	PKQCK	CPK
TWUIS	RWVJK	ADJ
FVKGZ	DTQVL	CZE
ZSAOA	XLXIF	RPN
AUXHO	NEMJN	WMK
NUHHE	LLIEX	VYP
EARVI	OBSOH	ABW
YXQUY	NTZYD	RKJ
DIOGP	EBQKG	VRT
RMGPJ	ADWYP	RNY
CCRCX	VVNRV	QJI
BJPKA	VPNYK	WXT
OEFEV	XIGQG	MXL
OEHOH	SEFMK	WRG
TXVID	DUZVR	KGA
XVNGF	LNGOI	EFZ
IPWWD	MRSMC	MVL
AHAMZ	QIXYC	CHZ
HBPQX	KJUBL	OST
WWLYR	TLWSJ	ZIA
IWPKR	DSHGZ	MSZ
LDLXD	BRUEB	YXO
CNICM	NOFMI	XUU
KEGMN	PRUTW	FNM
TDFQR	FLXKB	TUV
BVNCO	QWALP	ECT
PCKFS	DTNAY	KFM
TAKDE	HIDOU	YHC
VFKXW	EIEQS	HZR
ELTTH	IIFUC	TTV
PEANX	NHQIJ	APZ
JMAMI	KAHDI	LVR
MRDRO	LEHVZ	GWB
CQYYZ	XBKDN	TFG
KFGSD	ABCQH	HOO
THHAU	SHNFE	NQB
GWIFS	WZLPQ	IJQ
IYNMO	SQXVV	IEL
VKQFY	AQLSZ	XFM
UYBHR	XUWTG	GET
SNAEH	BJTFG	VTF
GMKJD	OHWWT	IXT
HYGDW	ILVWV	YZN
MXIMC	FYMPC	EDJ
MGHKY	NDRHU	YPF
WESNA	AVCDT	BCA
RIMDM	RVWJE	CPX
XOBBJ	IHLIF	YSD
YLCAB	VDDSL	EBZ
QHRGH	NNEAU	HGN
HUZEN	FUWDO	SVR
ACYAE	KJKBR	YFP
IGGGA	OVFIO	CDE
VBYTL	FSCEZ	WKF
CSWIV	RUHSO	ADP
PNGEO	SCYXH	WCA
LXMUA	MFXOM	BPQ
MQAOK	ODMEY	SST
RWMPF	JKDXF	OPL
ZOXOR	AEKES	VJN
MBVRI	DDAKG	DBQ
IEKME	XZIXR	AFA
ATUCG	AEQEI	YPG
YLKOS	GKGBE	TYW
DOQDJ	YIQNM	AEK
ZUUHM	MNCYD	EBA
EARAE	HHBEC	URJ
CXHFN	BKPWH	YKM
CYAKT	XMPQS	QFN
CWWSD	PKHRI	AOH
IXYDV	CZQSX	SES
LXLGP	AQQQF	APN
LTQAD	TMTXL	NUN
CTXWX	TMMTK	BOC
RFRGT	UECOC	UJW
LRYVV	LYTPY	XSG
XRBOW	ZIOPZ	NII
GNYLM	NOMKU	GGA
HXSWC	VBFCG	YNL
KOTMX	YIEQO	ZIO
ZKLOW	QDBDO	HFR
TVFOI	FRBCC	KTO
FZMXB	BMSYO	YAD
ZPVPJ	FERMU	BGE
OBPEI	AYZGH	QGI
RMKMF	EXXNC	YGY
CTXMF	CCKOB	LMW
HFFEM	EZGUI	JRN
IGQDY	AHWKE	CDU
WFNAL	HGNLN	YFV
GVDCW	TMVOE	GZR
PFJLA	ENXFM	CDO
DEIIR	LTWFI	NDA
PPYYY	ATKTG	ZUA
UREEB	PMPPB	EKE
QNSXL	SJHDO	CRE
NOVTL	AVKDK	JVF
MGQNF	OFGII	OOR
OEKNG	EEKMG	YIC
QPKVL	NVNXV	DWN
KWFIA	ILRRG	QHR
TYHRW	UGQJY	NSR
BKOFT	ZFRCZ	QQJ
JXGFP	OXFDW	EZH
ABSDA	YGAYM	DJP
VVAUN	RZYPI	EPF
UCONH	DWWFN	TIE
JDRQG	PGXUP	CKK
WKZBN	XRWMY	JDT
XCMJA	NNNKC	KKP
FDFEJ	BUROY	BMH
RVBWQ	WJBYW	OHJ
KTUMM	MYAAU	NGN
RNWEI	GONZM	MFI
DSJIS	EEQDP	QVV
DLMLF	GNENG	LVM
PREXX	ECJJO	MUZ
IGHUM	MBNPU	JIH
YORXT	BTGXT	TOP
CXZMY	GZWPV	DTM
IWWGY	UXBAE	WJJ
RRWPT	CDEJA	DGD
RATZO	TLAUC	IXQ
WHXKU	RESOM	LPE
OFGCX	OPSVB	CBT
FQOOR	FFZGP	OFM
PSXQJ	LIPCR	HHQ
YAGLT	HJVPF	PBD
QIJTP	ZFQWL	ZAN
IAOTW	RAEJJ	GDA
NUZRX	GRLZR	QVX
MWQNL	RIZQT	TBI
ENBEG	SFRZK	YLT
EXLSY	ZYKOR	GTI
TXQGX	PISQT	ISW
LKVVZ	VHKFV	LDX
GUPVI	GXEIK	CQJ
TNWVM	GGNVZ	BUW
HJDCM	JILQS	GWV
HDXHG	SPHHP	UAO
INUAD	TNZPU	YME
FHCQH	KGEMS	YNT
GEJFM	BDGAU	WYU
ZENOE	NYCSO	FUD
KVVOC	NSCAT	ZNS
PZYEX	RIQAM	AHY
DNFHF	JAEHD	ODD
GAZYL	FYSYQ	DKV
FENGS	SPFZI	GII
RYCVS	NZUAV	BFH
LYFKY	OCPAB	JFJ
WNMRC	HFTHI	WTL
CWNUO	KMOXL	CCA
RJQUO	AIHTM	OGS
BQPHX	ESKKR	YED
QSEXE	GLSXQ	FCT
ZCJHZ	CJZPW	EZA
UKVZZ	UUSRL	BSM
ITHZI	CZGPE	HTL
ZEVLS	GSMPM	PCD
KTPYJ	RYDAF	WMZ
DLDSN	NPYPZ	DNX
EBYNK	MQDME	SPA
PCAKS	MIMRK	SCI
RSPTB	XSJLP	XUW
ONKZL	JNEYC	HBU
KWZJF	VQTMJ	GRF
QRWCE	GUBQN	BTW
SXEPL	EUMIT	WGW
MBHJY	KZJIE	NIP
UGTKE	GDDHX	MDG
RXJOT	BWZEI	IAS
UZSDR	QGDBX	XRR
PWTSI	PQRGU	XNV
HYFGR	BBOIL	TQD
SSBKX	REUKL	TMC
EZDKS	RXWCU	FVL
MCCRA	LTISU	QXB
FEQWO	OHDAX	LUS
VCTOT	ZOTDK	OHG
TUEBY	TQAOL	ZSO
BVZMJ	CBFCM	MNH
CFJTB	GMUBV	UFE
QAXUZ	QMWED	CRP
LPNWF	PALVB	SSO
XDVJZ	BBGVF	WQP
KMXXQ	QUOTI	HEV
QMNAU	VSNVF	MZR
ATSHG	YPUTK	LPC
ADEZW	BJYBX	PJH
HLXHN	SMSQE	XWP
MQIZV	TDSYO	MVI
UEEVK	SBLAG	PYF
DZLOZ	VIXGR	UZF
OOEWD	PREDH	QZR
CEFNQ	XTYMS	WIS
HTKUH	VVAWA	MKM
VPNJC	TDQTL	HRR
LSXQA	WLDFC	RAU
ADBAM	CZOFC	IUS
OFELQ	SJXUP	DZB
PTSOH	XOAUO	FGP
IOPUV	RESJK	BLF
EPRCT	UAQIE	FTE
NKNSS	GEUCT	UXT
OOCVM	VVAOI	MHR
KWKSU	BRKFE	GFU
RUBBT	ABNBW	VJV
OYTOL	WGTOD	AUH
SASPX	KVHRF	MCL
UZMFC	MOAYM	RJF
HYKRB	PQJHG	WUC
NHXMO	BWCDO	ZXV
DBYJD	CJSXS	EDS
MPRRD	FNFFE	QVE
UHOCG	NVLOB	JIS
SAEGI	UHGWD	YUC
ESIXL	DFVKL	KUS
UQMUC	AVYBC	CLE
HMDSA	XHGMY	LKO
ZQAMQ	LQNER	LBP
DXTOE	HARLS	GRB
ZMVCO	KNAHN	ERE
TMTCL	QZXFI	BJO
GVOIK	JDYAQ	XOO
EFCOL	PKQKK	ZAZ
HJJYR	SKZRB	KWU
NKLDZ	QRQLY	NAQ
JLVYT	SOZFK	WZG
PSYGT	IMMAY	KRF
TGARC	QFKEY	KYB
TPMTS	LVEZW	WXE
GHRZB	VILMH	JOQ
MPYCA	ROSLN	SGK
RSGSR	YABWO	AGE
YYWWN	NMHKQ	QJC
YTRZN	KZHJM	FCA
KLWKY	GBAHH	UFX
RIPCZ	GPVPO	SCC
OTUHT	HCLVV	IEG
CCZHU	ZPQAD	OUC
OKAFM	YJRLI	IXC
IPOWO	GDSNG	SWE
GONMY	HFSCE	WLF
OKSFM	LUXVA	ZTT
OOHNS	BGJNJ	NLX
FKSRD	CJCWK	IGY
WDSBZ	NUECA	VGZ
ZMCXB	GUACV	DVI
GKXSH	PRPVL	MXB
KZLYX	TYAVP	UAR
KMLGQ	IVUBO	JVA
FUQXY	MVJVZ	ERC
NFUGZ	SEILU	ABV
DPSPO	CPJIG	BFA
JVJOY	LUGDM	QSQ
ZTBVT	FBLJI	JHQ
WXSUS	HQAGQ	TVN
BEJCG	XVQJZ	LPR
LZJZO	ELFVG	XLM
IXIVQ	DGULU	RWQ
MDVCV	ZFHWH	XCB
DBJFE	SMDDJ	GPG
ONIDM	XAXRO	QQR
PTSDC	CPIIE	XMO
BBSOU	PKDPE	GEU
DFNOB	HLXHW	SZQ
XMOHR	BVDXW	XTQ
JYLGH	AIAZH	WMN
TXJML	DNTRW	ZUH
HGOLM	ECQOK	RRF
FZVPO	XFQAW	EPP
CHFSX	CVLFB	LRY
ZIHFB	SVTDE	ZOR
SWGBB	PTSFI	CEG
TJHMV	TBFEJ	FEL
TBOPC	PPRJR	OHV
XZKHU	XFSEH	RRI
LDGVX	OUHNJ	YFG
WMLUW	QQTYM	JNH
QOBWF	KQEQD	CCH
NGEIN	DITFW	UHY
KSDLV	KMXTV	IUT
SEOID	VIZSC	ZIH
NSWYA	UKEVC	UAF
WNQGR	BZJYY	TKB
LVDQN	EIDLW	ZQN
EXWWG	ZYOHK	OAX
CXOQA	LMFIE	ZDV
DCBPT	YQXMP	CKM
VXOAY	FOVCO	SMT
GRYAH	ARHWN	AXM
DFXYZ	VPEWL	PGZ
JARYE	FQRNA	VNB
HMERA	DRVYH	VCE
IVWIO	QYQRU	ITW
XCYPM	LHWXQ	HMV
BDFYX	YTAFG	HNM
HSVXP	ELYIT	UAS
VYWKD	OXWAT	GJG
XCCGH	CWUBH	AHF
WEXNY	OHNSP	QIL
ADJRX	CLKTT	SRH
SMBEF	RWSNX	HOI
NDMOC	OZVBY	CVT
IFZUO	WPQTR	GKZ
JDKCO	RVBQQ	UJZ
VBWIN	GWSGF	VMI
OQYBM	KXIJJ	WYK
CFIBN	LTNEJ	BHP
YFRTA	MJCIV	RVB
KYNNT	XYXLJ	BKW
HWKWL	QNCLV	QOQ
AISMM	VPMQV	IBH
COCOC	FCIGA	MZQ
UGTIT	RRRYB	UAH
WJYWN	RKUYL	VUK
EUPON	YUTJG	FUO
WDUCY	GTDSY	XZF
CGUPU	XBNBG	JLA
NQRNG	XVNGL	BLC
SDGFA	MCTID	SBM
LHMLY	FRAXP	KRC
JETCR	AYPRF	NZK
LJQDD	OSFAE	CIB
FXNZN	EMYIO	JNC
PGLPN	XMNBC	VUI
LELNG	FPOEO	OJY
XDBRA	FWZEU	YQW
TMWUA	PLTKP	HFP
IXSJN	GALHR	CHT
OGGGT	DPQWU	WNE
GRPWY	ZLZJQ	DWP
GVVHV	AWSTR	ZMQ
FNNYF	ZEYHS	VKR
HZFXM	PJJRB	QIY
SKATZ	TJGHL	XYV
KWQPW	GZGOI	ZUB
XVWIW	ZODYE	EOS
RQSDS	ORNEK	RQT
BHQSV	FIUTH	CIX
SNMDX	NWHFJ	KUJ
UDNIT	VXPHV	JDK
WWYRE	UWUCV	XRN
FNHGD	SHUMS	DLG
RYUJF	WZKBF	LLO
LTYHT	RUTLP	EKW
HZRQC	LXCWH	JMN
WMGQF	KAVCW	ZHY
VSZKB	MCRCA	VNR
ANDOP	GYCVT	MNM
KASJK	HFWFV	QPX
NNFKP	XVNTJ	USI
FTQTC	UJUJR	WDK
WHFAM	DBGNC	YMT
BZMRE	KYJCV	EUK
LPKCN	QTNGM	GHX
GYHYX	HBWZE	VXL
ADCNK	OZMTC	MTS
HTDPL	TFZIN	BUA
DXCBB	AVBRJ	FNQ
JTQFV	XPRHX	RUI
PUPUH	BWDYU	XBG
VRPKY	WPVLP	TGP
WUQTK	SOUJM	UKA
DUZIQ	VLWOZ	ESO
YRRCM	BRONF	SNL
AJWZJ	WCNXB	IWF
YVQZP	GFEIH	BSJ
BAWXM	MNOJG	GMV
IBAXV	YRSBN	JGN
LLXHQ	FBHPS	MIV
AHMZK	FGWVO	PWZ
FFXBI	INSZC	GBL
LZBYM	ARXFM	GRQ
HPFJG	QRLTH	EXM
VIKGK	LUIPD	NKQ
ODDSS	GGAUM	SML
GMKIJ	DTIZT	BNP
XHSBF	NEPVV	IXI
CIPTN	XWNSY	LSX
PTZXM	HDLVT	JZH
UVSIN	RUWBZ	KZF
LFWNO	ZIZVR	RNK
JYYVB	XTTWP	SPQ
BXNYR	ARYBH	UAK
SNDPT	UYHHW	RCB
UQMGK	OVVSY	LCS
DAWDJ	JGCHP	NSU
BVYBC	CSREE	URX
ETSBJ	AVWCG	DVP
BARFL	ITFJW	PGB
BLZSE	SDUBW	XNJ
BALXW	CZRYJ	HQH
TDSKS	WHDBS	CMS
BLRNT	ZVPBK	CVJ
BYMKM	ZGLJO	RWI
SHNMR	CNUHX	NXR
JMCRE	LCEAN	BNG
FHHPM	QNELP	VDI
NQDEU	GBSKT	LKB
ALQXI	CGUXV	HVW
TJHYM	MELVL	TVW
HEVXH	OGJAW	OAL
XGPHX	CJRCG	WTS
ZJDEN	GNLCV	QPH
RRCHC	KLCFR	JNQ
SKWOF	JTVXD	HFY
TECWE	GXSNZ	TOL
ZDRKF	NUMGQ	UNX
LVIZS	LIXVC	KEX
DKOJN	UDTLE	USL
ZLJKK	AIPZT	ITX
KSDHJ	ZWNST	DRU
RZTQW	ZVOFS	DIP
VLPXA	PZQTZ	LTO
LNNNN	CORBZ	RZZ
FFUQG	CXSIC	ICB
JQWHG	NTJUS	SIO
DJGFP	ZQEFB	AQA
HKGOJ	XDMBH	SZJ
EEVLY	DUKLI	UZI
VMWSK	KFCCY	WCR
DPBCH	UYOFL	LZE
ZIWMR	KFNAU	BRU
DNCRU	HNWQV	FBB
UHZOD	QKTON	XRS
KUURJ	JELLQ	PYK
VFECF	KKSGZ	DXB
WKERS	UPDXK	ADE
ZKXRX	LLXOF	DKG
RLMMK	EKMZH	TMP
QDITV	HQARN	LTU
PUCPC	FQYGJ	UNM
DKCEO	ZDXFK	CST
IKAGM	HERDG	DTK
QWAYS	MAVNZ	GOI
RZQIK	HVHZN	XTV
DTNSU	XGCGD	ZOE
UDZOC	BRRJG	PSQ
MEHAN	EVCJO	BVX
YAHOH	SJFSB	VMZ
TLQXT	BEAHA	TQT
MXCCN	ARSXI	CMJ
HMZKG	GWLUW	GMS
LHONZ	BMYJS	KBS
HSFDW	BBLCE	KBU
QRUQR	HKTWQ	KTU
VCJGA	IUDQH	ILS
GQUBH	YLXOD	QLN
ZJGQE	RFWLY	DTG
XAMDQ	RDDDQ	OQS
EYZZY	KQZNC	ZEA
EPUFZ	VKMVI	UHX
EIDZC	KSTIW	DHX
YBXRB	JBCXY	AIT
HATHL	MPKBV	HOM
SSYDB	NFCSX	PJF
BTWWC	VSLWR	XEN
KRQND	OFZKT	QVB
OPZMQ	RTFFL	ZCY
RLYIG	SJCEN	XIP
XPHVZ	BBECG	EQL
IDJRU	WTNNQ	MOI
OTYPN	EYGGU	ZYK
JWJMV	JKRPX	SNP
ZZHMU	VPVUV	LCC
VANEM	UJUEM	KYR
HMGYK	WWWGM	HYX
LFJKF	UPDSD	NFQ
PXSPK	MASPV	YEB
JSGHX	DOAXW	UXR
BWJTJ	ADRUU	TRL
FXVAM	UDSQU	IOO
DZGAK	JYWVR	NTJ
VZTAR	ZMUWH	SIM
ZRWKO	GIVLO	PQZ
CKXYF	YCHVX	VAA
OTTDD	GZSAU	DJQ
GOZPR	RPUFC	CTD
JWVKY	EWDZH	EJH
ZDDSA	PNKUQ	OQF
JHTSK	SUYOM	MNX
PJFQM	KPGLG	IPC
NPHXX	ALBBM	EJF
WOEFN	VKYTQ	HEH
APGAG	MKNKQ	KII
YGOTC	BIHDA	OUL
WNXES	BICMP	TCY
EUPCJ	ATYCB	FHO
UBKER	JPBJL	JQZ
LAEMS	IGYSN	EKC
OGCLA	FWQBQ	YOI
XPFMD	EDIZY	LCL
XTIPT	JSVPX	KWH
KLNVL	IVKSN	UAC
LPCJV	QMJJJ	PJA
VQXXM	GWANV	YIZ
WUQNE	DGKIR	HAR
FCMJM	VDLOX	SAD
JUQGC	CVNXI	IYC
FMKVK	BKEDN	BVK
NVPND	SWZYV	LDL
RYROU	QKQSY	PYA
XJXJR	OGSPO	EZQ
DAWWK	IRMYR	TXO
SCKOW	MISID	ETB
UZSGD	HIBFN	RBI
IYGGN	XKTHJ	BPC
QEYDZ	IVEJE	LFY
QWXCW	PPHPJ	FIV
FSSKH	BIWFV	AYV
ZABMX	BWAXN	DPY
ZZRAG	PHWAX	EFC
UDJGI	QEHTG	WJT
CMHXB	ZUKFM	UMO
XJOXJ	UICYV	LNT
LCSFL	PAVOM	WSW
TJJGE	WFOTX	YLW
YFRHB	MIRQF	GOH
HIDYX	XNOMM	TUW
HTHJT	HFVVO	PJJ
RZWLE	EFINM	GFF
UEKGZ	ZFVMN	DMX
JXDNJ	UHMSQ	FQJ
DHAIT	QZNHR	RTA
UUXQG	YBVRQ	WIY
VXWAK	LMQHO	AQD
OTZSM	ZUJWE	FOP
XRJIR	XJTGI	GFQ
UVKCC	GKNKC	WHY
DZMAQ	TSBWQ	CWD
HLQHC	PMOPN	AUS
MYFWH	XLDTV	COD
ACORR	VULJN	TOR
JXNOG	YQAEX	JOZ
MOLSB	KYOEO	LXN
PGZAZ	CLXUT	GQC
MEETA	EIVIQ	FBH
CVOQM	PHNZK	KBN
XTMMK	VLFSS	XHS
ZHOUF	VUAJF	JHJ
YMAGH	FJKIL	UOM
RSYTE	CKLOU	JVW
HDXQZ	ZOJHJ	XUG
KNKXR	IGPHP	UFN
EHFBZ	IZZZS	HJA
VTWLE	XGXGH	ONM
CVESR	LFBPO	TUK
WDKQN	UQLSM	DHG
WRSBS	NELPQ	WTH
IBAQC	GLRDN	GIW
IVCZA	ZEEZY	LOF
VBRPK	ANXLN	PWN
NVVWI	UTIHP	PXM
TBRJV	FUHXU	WFV
PACJC	XJSUS	GXR
AOQMQ	NSEDT	WJM
XKWYJ	RFGBR	KTX
YDSCF	ISIYA	GQA
PUWBH	MKFHB	NCG
GQQNU	EERMO	ETR
NJGTT	WTUOE	DYZ
WCSKK	ZHXHF	LVU
FKNWH	FLDBK	RWT
HSPXB	OSZBB	ISI
YAYSY	HGRBX	WJR
TLSKY	LUHEZ	UXL
ICAUK	LGJJO	POT
VHMGZ	QZZHT	KXR
GQVDE	YODTX	SQC
SQCHH	DOFCH	ZNU
SGLYE	EZOMT	PFW
LAALL	WAWZD	NPZ
EODWZ	AOCPM	QTB
JAWVB	EAGUD	SCA
RGFFH	WCOCR	KFF
JVWZF	AUURG	BMN
WTMQQ	DCYNU	AEV
JHRSZ	ZQHTA	OPD
WTRJR	ZHJYC	PVB
MOZRZ	TURJA	EQP
ZKUYQ	ICWDO	APY
KRMKK	KCYDE	NKW
EGXFW	ITAGO	AWN
LAPFE	XEZJP	IEJ
QNVNZ	IZSWX	JBS
IIOLN	UNUFM	AUY
EMLAS	DUAQA	HKY
NVZGT	VAHOP	YNI
JBLFO	WMXSY	IRQ
BPOMN	RHCAL	EQQ
NYGMV	VAQMF	INY
KCJTK	WIWNJ	RGZ
REVVQ	JMGKH	YYU
MSFLK	VFXII	GSP
QTZUN	AGZTU	GNK
BAAMG	YRFSP	LPD
YNROE	RKHVN	RYS
UYSZB	HZZKJ	ZKE
FSQNM	JOTGD	LZF
HTGZH	SDTIF	ACX
VBSDZ	DHZAR	FPT
QOKDG	DTNRF	XMY
LZMLP	ARUHI	YNK
BPSWB	RAANQ	EPR
ANEDP	BRSKT	ZPM
RUGNK	NLBRL	CUS
HTBAP	PGWPJ	ULV
HVZTQ	RFURO	AQE
NGXIC	RDRYP	YAW
KJMWD	YKOYG	YOX
DUURT	XGAZY	DMH
QPNWG	PWEVI	GRD
CCUMN	DGIIC	AQM
YIXRK	KZSDM	KTQ
AZSXE	CNQUV	UYN
BCWHM	MNDMR	OGP
WFTLT	HNPAS	OQY
KEBKV	BBYNT	APO
BGVNI	WLRPB	ZVL
TYYKN	CGDQF	DXS
BRBPP	HWZYQ	KKF
ORNEW	KJWIZ	BGS
XWYQF	KXGVK	IQJ
FUPAK	OAPGO	NIL
VXSBG	VBKGL	MBH
XPCIK	SZPHN	ZTL
CRUFG	CSJFU	NDI
WFDFB	WYGNU	AXD
LXTMF	ARDOQ	MDL
CNFXW	IZFWS	BDJ
ERRRY	YEKKY	ANZ
MUOZB	OSGFY	LTC
GDEPM	UGCDI	JMR
CPRWK	WRUAX	GKK
CMNTW	WZHHF	YXG
RUUHH	NQQJR	LME
AAHVX	IHDFW	ETU
DXSAB	OKAHM	HAC
DKMRJ	TKZLP	CIQ
UHASP	BHUCI	FYB
FCXPP	DNTMN	JOA
EJJJS	AETNJ	ZJW
YDZVS	PNKZL	STI
ZFIZE	GUNDQ	YPK
KTBUT	LQTMA	XUL
IYCJJ	GIHIJ	PDN
QSQUY	JVDTS	RPE
IDWCO	CSHZS	KZE
EEGXQ	MRWVM	AXC
YOZRC	QHNSC	KIY
ZMQJP	MTLWI	CYW
YAIWG	LAPBT	VLM
LRKKA	ONRBE	LJG
XALXQ	TASPA	YEI
KJFHG	DEQBU	JBF
VXOVH	ZHKRU	FEE
YIAYG	YZZZP	CAI
IDVAQ	WPLXX	WRL
CBWML	RRWNE	AHT
XKQRR	RHEEC	IJA
OUOIU	GEFRI	GMB
IIJAN	TBGAB	KPC
UCNGT	HNEGY	NCK
IBAJF	XLPPE	VPO
MOSVG	IBARJ	UIF
DJGPC	JUTJF	OLN
ALNYL	JGGNJ	HKN
ZXTMM	OMEDH	FWX
GMCRP	ERRCI	WMD
OBHQN	UBBZT	WVP
RBVMU	NQQVV	VED
UXHJF	TCMLL	WCF
WROTV	XURND	ZSD
GJLHY	XERXV	HDS
CJECF	AGHUB	GFB
FEKAO	AJTBP	BOE
AIGEL	RETSM	UJM
KITGK	EVDQS	YRS
EBCKG	ZAXGS	QRQ
SDFCF	HEGZL	CIE
ICJWE	FTRCX	RAD
FQSVO	DHWIY	TFW
LGYWD	SGNZC	JUK
KQLMZ	JTYSG	SVY
AOYAY	DIGFL	IOV
HERQN	RDKFP	KRO
NPXTQ	XISRA	UFI
HYKZI	NLDWO	CZF
XUUBO	JGWKP	KDU
SWGTV	QRQGD	RMN
SLKXZ	PKLQY	XXD
HWCAF	TWXFZ	GHS
SITYL	PHTAA	VBO
EYLDT	YSYVK	GQS
KCVTT	ONABQ	MYA
MZXFF	TUGAM	WCP
DEKSI	VQEZP	ZCZ
VDXWL	CGPEL	GCJ
KDLGA	BPPQG	JGI
PCTKY	MDHJR	NJM
KHKYX	NVROG	LHJ
RETWD	SOGTZ	GWM
VELVA	LOQPP	EBY
ZWZWQ	GGNJL	WOG
OUMBA	UBZFJ	UYI
ULUPL	WLPRV	MAJ
OYSAG	CONDY	SGJ
UPJEM	QHTSK	GNM
BKZUN	YSQUB	PLO
MDDNM	GGCEX	UOJ
LZCLP	AWBIC	DTN
TIXUH	DCDUI	CCS
RTSZZ	VVHAW	BQH
IGDCI	NDMVR	MHF
VFEBL	ZJNLG	PIF
NASZD	LLAMQ	HPK
PPVQB	UXZCO	ZMS
MZEXM	KZXUC	ZAM
FGHUO	AMKJC	KKO
JKFPJ	NHJIH	AEJ
FLLAH	TAUXG	MJP
LWPQX	GGZAD	BQF
YMWCA	SWDKO	NRD
JSHGD	IJGTF	EDY
NYKCC	BNXZO	VZN
FSYNP	OUNYN	DKF
TDQPL	BPCKU	LQA
QGOWV	MKMME	QND
GFQXQ	CZVOL	PLS
TMYWS	UWWYF	GQG
MLXUB	XADXG	ZHC
DEHWR	VMRZT	TSX
UDOJO	BPEOD	ZUD
OOTIH	BGCGW	VMB
LNNHL	JEYPB	RKR
TWCVE	YWZHH	CPF
NXWYM	FVWRC	VGJ
KBEOZ	RPABA	NHZ
ZJRTK	RBGPG	RSI
UAYYC	QEBDE	PGR
QRSLG	SSZVX	NYC
KPFVQ	PIGWR	YFA
MTSNZ	HRGNG	BBO
UBILQ	YMHRQ	RPU
QPVTG	GRFXF	ZQE
WHNMF	MXWTN	TTZ
GWCAP	BKYRK	JSR
GWTOU	ILHVJ	IUP
POYYU	ATRYI	OYE
CWYUL	UDVRY	SNR
MZFJW	ZMIYH	WIG
MJFXK	ORWEG	UWO
HDORS	QPNHB	RDI
XPVTO	HKIXE	CEK
RDUXI	AQAPI	BJJ
JARQK	WMQQU	TNE
XEZLM	ZXBXM	FUN
TCZAU	RBNCR	JUP
NRZXV	YUKQH	WYP
KCKKJ	XMZJS	UVI
FGDLF	TMUWK	JPX
UWCKH	PNSHH	VLC
QXEZC	DDLUO	RUZ
QZZQN	BFSKS	CLK
FFLOO	NCYZR	CLU
CDFQC	SJAJL	NPI
FQUVZ	MXDNM	VWV
ZTTTF	TIIQH	VQD
AUJCS	VWDFS	TLD
QTVPF	PEBZK	JXW
OHDSS	NLGNK	UQE
LLJSX	ZIYHI	BLB
ZBVWC	IBFQD	FBJ
ECLDA	MCEKX	VNU
WVKKO	JKXFP	RSW
KUABQ	LBJFP	OXS
WMPGG	MYOSH	VFM
FTLOK	USFWL	RWO
YDXZG	APRSP	LVX
FXZNX	RAASF	OVR
VBYMA	CFPBI	NEH
IGZNU	ETDDS	JCX
HZOUE	PQFTR	IJF
WJSJK	LSVHZ	ZWW
YKZXG	EAQCQ	TUM
XPBBA	HNFEN	KRZ
VDXBM	DCWSV	RPX
GGHSW	YGXXJ	WPN
WVXBY	ZFHEJ	HDM
ZSZSS	JYEKP	KPW
QZGJY	LSHWA	CNF
ZEVQA	IURLC	RLK
YFCKX	AUGUY	CON
GVYCM	FPWCA	XOG
KVIDE	LRXSG	HQZ
RPVVJ	JMBAK	VOL
AIBSI	GJUNF	TTR
JJSJQ	YGCJY	FMN
RBEQY	QWYVD	GBH
QAUZE	VQTNG	PQW
XFAPY	GOHZL	BOY
JLDZC	KCFUV	IZZ
MGGQT	KCMOH	FAO
FYALI	MWPDL	XQF
CHVKB	NRUGY	PPO
WYNQI	TBEJJ	MGZ
WCNCK	IMFFV	YFB
JCKNQ	KETPP	HVD
IWCOS	LOVZB	CDT
WCPKF	PSORF	EQN
EYWEB	ZVIBX	TDM
DINTQ	EVNCO	JJB
JIVUK	WHFVU	OXG
OFIBY	BDZVG	YCP
MOLAS	YRQGD	IGO
KGGGK	OEVJV	PGI
LQYJI	FFGMP	AWJ
IDRDG	ASIXE	ULD
SMFEB	NINCH	LOM
HKXAJ	KCVXC	EQE
NMXBI	RDGJU	IHX
ZRXKN	QADXQ	QUY
ZNARN	PWHYN	JRU
PTYZX	KCGTE	WGD
AXHRG	VWNNX	NTF
STZXK	AAGNJ	RDQ
QMYZZ	CBGOM	MVG
QJRQZ	TIADI	JJH
USTYX	SVRMT	RLG
GFMDK	KXNZC	ICX
JWLGK	DMHLP	XIX
QTDEN	ZRKWX	DUN
YFHAR	CCEIQ	DVM
DAYSL	SIIDT	ZTN
ZJVKY	ZENNX	QCD
SEABQ	TGVRK	WUD
YIEXG	IBDZA	ESI
TXZMH	IUAND	RTC
VXTQL	KZPMF	EGF
BYHJF	QHNHN	UYW
HNEFA	JLVMW	ZCN
VUGCJ	SSLYN	DFD
RBIQE	TAWLB	VEK
RKIFC	RJFLH	RCR
ECRCU	JMHZC	OYU
WWCNV	OBYUQ	EIW
MYPHN	BDSLU	VJP
BQRWY	HWZYD	YEU
KFSRM	NZSZZ	QZU
GTYPF	HLBLN	YUX
XINGY	TZEYA	BVH
BJZPB	EPYDP	XWD
OYESL	RSPGS	XWQ
RGLYT	RFGSE	ARG
GEBUO	JLEOV	TUX

